
                       NOISE AND HUMAN PERFORMANCE
Абзац:
 1.) Behavior - поведение
     Becoming - стали
     Permanent - постоянная
     Masking - искажение
     Harmful - вреден
     Undesirable - нежелателен
     Distraction - отвлекающий
     Annoyance - надоедливый
     However - однако
 2.) Artificaially - искусственно
     Response - ответ
     Rather - нежеле,скорее
     Either - каждый,любой
     Properly - как следует
     Correlated - связан
     Common - общий
     Direct - прямой
 3.) Measurement - измерение
     Specifying - определение
     Loudness - громкость
     Pressure - давление
     Reference - справочный
     Band - диапазон
     Weighted - измеряются
     Equalize - сравнивать,выравнивать
     Upon - на
 4.) Concern - отношение
     Major - главное
     Exposure - воздействия
     Capabilities - способность
     Impaired - уменьшается
 5.) Quantified - определяется
     Term - предел
     Elevated - повышенный,верхний
     Threshold - порог
     Reasons - причины
     Greater - больше
     Equal - равный
 6.) Among - среди
     Susceptibility - восприимчивость
     Occurs - происходит
     Disease - заболевание
     Cumulative - накопление
     Isolate - исключение
     Exhaustive - исчерпывающий
 7.) Desired - желательный
     Phenomenon - явление
     Fairly - довольно
     Considerable - широко
     Evaluating - оценка
 8.) Regarded - расцениваться
     Elevation - повышение
     Broadband - широкополосно
     Closest - самых близких
     Sensitive - чувствителен
 9.) Environment - среда
     Articulation - разборчивость
     Average - средний
     Degree - степень
     Intelligibility - ясность
10.) Reduction - уменьшение
     Since - так как
11.) Weavers - ткачи
     Gain - получили
     Reduced - уменьшать
     Matched - двумя
     Diminished - уменьшен
     Improvement - улучшения
12.) Widely-quoted - широко известный
     Sound-absorbing - звуковое поглощение
     Exerted -
13.) Less - меньшее
     Waste - затраты
     Condition - условие
     Suffered - потерпел неудачу
     Unfortunately - к сожалению
14.) Sensations - ощущения
     Muscular - мускульный
     Weakness - слабость
     Transmitted - переданными
     Tissue - ткань
     Sense - чувствительность
     Ahility - способность
     Widths - ширина
     Balance - равновесие
     Significant - значительные
15.) Degraded - понижена
     Suggesting - предпологая
     Subsequent - последующий
     Two-demensional - двумерный
     Equilibrium - равновесие
     Sway - раскачиваться
16.) Exposure - подвергаться
     Steadiness - неустойчивость
     Judgment - суждение
     Response - ответ
     Encountered - встречающиеся
     Disregarded - игнорировать
17.) Hammer - молоток
     Anvil - наковальня
     Intermittently - скачкообразно
     Presence - присутствие
     Consistent - последовательное
18.) Although - хотя
     Inconsistent - непоследовательное
     Yielded - выдал
19.) Vigilance - бдительность
     Infrequent - нечастотный
     Inconspicuous - незаметный
     Gages - датчики
20.) Deflection - отклонение
21.) Tracking - прослеживание
     Stylus - иголка
     Holes - отверстие
     Warbling - частотное модулирование
     Pitch - шаг
22.) Pursuit - слежение
     Apparently - очевидно
     Conventional - стандартный
23.) Mutually - взаимно
     Cranks - рукоядки
     Irregular - беспорядочный
     Jet engine - инжекционная машина
     Revealed - показал
24.) Related - связанный
     Eyehand - ручная
     Initial - начальные
     Accustomed - привык
25.) Dexterity - ловкость
     Ambient - окружающий
     Noticeable - значимые
26.) Overestimate - переоценивать
     Switch - переключатель
     Occupied - заняты
     Former - первого
     Locked - недоставало
     Given - данный
27.) Mental - умственный
     Vanished - исчезло
28.) Subtract - вычитать
     Either - или ... или
     Deterioration - ухудшение
     Surpasseg - превзошла
29.) Faced - стоять перед
     Decline - снижение
30.) Certain - определенный
31.) Obtain - получать
     Pattern - модель
32.) Immediately - немедленно








 COMPUTERS FOR CONTROL AND AUTOMATION
Абзац:
 1.) According - согласно
     Expected - ожидалось
     Purchases - приобретение
     Annual - ежегодно
     Reach - достичь
 2.) Incentives - стимулы
     Justified - выравнивать
     Expenditures -
     Keep Pace - сохранять темпы
 3.) Grow - рости
     Labor Cost - трудовые издержки
     Rely - все
 4.) Further - дальнейшее
     Safety - безопасность
     Tolerance - допуски
 5.) Trends - тенденции
     Suitable - подходящие
 6.) Petroleum - нефть
     Major - главный
     Account - насчитывалось
     Due - благодаря
     Obsolescence - старение
 7.) Shaping - формирование
     Casting - литье
 8.) Pulp - деревооброботка
     Rubber - резина
     Demand - запрос
 9.) Utilities - сооружения
     Dispatch - распределение
     Supplemented - дополняться
10.) Widespread - широко распространено
     Assembly - сбор

